#.###########
#.#.........#
#.###.#.###.#
#.....#...#.#
#####.#####.#
#...........#
####.########
#.........#.#
###.#.###.#.#
#...#...#...#
#####.#####.#
#.........#.#
###########.#
